###################
#........#........#
#.###.##.#.##.###.#
#.................#
#.###.#.###.#.###.#
#.....#.....#.....#
###.#.#####.#.###.#
#.................#
#.###.#.###.#.###.#
#.....#.....#.....#
###.#.#####.#.###.#
#.................#
#.###.##.#.##.###.#
#.................#
#.###.#.###.#.###.#
#.....#.....#.....#
###.#.#####.#.###.#
#.................#
#.###.##.#.##.###.#
#.................#
###################